sed non ipsa parte exire habebamus qua intraueramus sicut superius dixi quia necesse nos erat et loca omnia sancta ambulare et monasteria quecumque erant ibi uidere et sic ad uallis illius quam superius dixi caput exire id est huius uallis quae subiacet monti Dei	Nam ostenderunt nobis etiam et illum locum qui appellatus est incendium quia incensa est quaedam pars castrorum tunc qua orante sancto Moyse cessauit ignis
Sane licet terra Gesse iam nosse id est qua primitus ad Egyptum fueram tamen ut peruiderem omnia loca quae filii Israhel exeuntes de Ramesse tetigerant euntes donec peruenirent usque ad mare rubrum qui locus nunc de castro qui ibi est appellatur Clesma desiderii ergo fuit ut de Clesma ad terram Gesse exiremus id est ad ciuitatem quae appellatur Arabia quae ciuitas in terra Gesse est nam inde ipsum territorium sic appellatur id est terra Arabiae terra Iesse quae tamen terra Egypti pars est sed melior satis quam omnis Egyptus est	nam et pars quedam fluminis Nili ibi currit
Nam et locus ille ostensus est nobis quasi modice altior ubi filii Ruben et Gad et dimidia tribus Manasse fecerant aram in ea parte ripae qua est Iericho	lecta etiam pars quedam Deuteronomii in eo loco ne c non etiam et canticus ipsius sed et benedictiones quas dixerat super filios Israhel
Itaque ergo proficiscentes de eodem loco peruenimus ad radicem montis Nabau qui erat ualde excelsus ita tamen ut pars eius maxima sedendo in asellis possit subiri	Si uultis uidere loca quae scripta sunt in libris Moysi accedite foras hostium ecclesiae et de summitate ipsa ex parte tamen ut possunt hinc parere attendite et uidete et dicimus uobis singula quae sunt loca haec quae parent
Maxima etiam pars Palestinae quae est terra repromissionis inde uidebatur ne c non et omnis terra Iordanis in quantum tamen poterat oculis conspici	In sinistra autem parte uidimus terras Sodomitum omnes ne c non et Segor quae tamen Segor sola de illis quinque in hodie constat
Item de dextra parte ecclesiae a foras tamen accessimus et ostense sunt nobis inde a contra duae ciuitates id est Esebon quae fuit regis Seon regis Amorreorum quae nunc appellatur Exebon et alia Og regis Basan quae nunc dicitur Sasdra	Sane de illa parte montis quam dixi sinistra quae erat super mare mortuum ostensus est nobis mons praecisus ualde qui dictus est ante agri specula
Ac sic ergo facientes iter singulis diebus ad subito de latere sinistro unde e contra partes Fenicis uidebamus apparuit nobis mons ingens et altus infinitum qui tendebatur in longo	Item perintrauimus in interiori parte palatii et ibi erant fontes piscibus pleni quales ego adhuc nunquam uidi id est tantae magnitudinis uel tam perlustres aut tam boni saporis
Ita autem turbati sunt Persae ut nunquam uiderent postea qua parte in ciuitate ingrederentur sed custodirent ciuitatem per giro clusam hostibus in miliario tamen tertio quam tamen custodierunt mensibus aliquod	Haec autem pars specialiter orientalis appellatur quae est in confinium Romanorum et Persarum uel Chaldeorum
Et apertis baluis maioribus quae sunt de quintana parte omnis populus intrat in Martyrium cum ymnis et episcopo	Et quoniam in ea prouincia pars populi et grece et siriste nouit pars etiam alia per se grece aliqua etiam pars tantum siriste itaque quoniam episcopus licet siriste nouerit tamen semper grece loquitur et nunquam siriste itaque ergo stat semper presbyter qui episcopo grece dicente siriste interpretatur ut omnes audiant quae exponuntur
Et quoniam in ea prouincia pars populi et grece et siriste nouit pars etiam alia per se grece aliqua etiam pars tantum siriste itaque quoniam episcopus licet siriste nouerit tamen semper grece loquitur et nunquam siriste itaque ergo stat semper presbyter qui episcopo grece dicente siriste interpretatur ut omnes audiant quae exponuntur	Et quoniam in ea prouincia pars populi et grece et siriste nouit pars etiam alia per se grece aliqua etiam pars tantum siriste itaque quoniam episcopus licet siriste nouerit tamen semper grece loquitur et nunquam siriste itaque ergo stat semper presbyter qui episcopo grece dicente siriste interpretatur ut omnes audiant quae exponuntur
Pars est prima prudentiae ipsam cui praecepturus es aestimare personam	Nam plerumque has noxas corporis ad inferiorem partem quae supra sunt corrupta demittunt ut uitiato capite ad pulmones uel stomachum morbi causa decurrat
Dulcedo autem cognoscitur si ex ea parte agri quae magis displicet glebam fictili uase dulci aqua madefactam iudicio saporis explores	Sed ubi haec quae naturalia sunt ne que humana ope curari possunt diligentius aestimaris exequi te conuenit partem quae restat industriae
In frigidis prouinciis orienti aut meridiano lateri ager esse debet obpositus ne alicuius magni montis obiectu his duabus partibus exclusis algore rigescat aut per partem septemtrionis remoto aut per occidentis in uesperam sole dilato	In frigidis prouinciis orienti aut meridiano lateri ager esse debet obpositus ne alicuius magni montis obiectu his duabus partibus exclusis algore rigescat aut per partem septemtrionis remoto aut per occidentis in uesperam sole dilato
In calidis uero prouinciis pars potius septemtrionis optanda est quae et utilitati et uoluptati et saluti aequa bonitate respondeat	Fundamenta autem hoc modo ponenda sunt ut latiora sint ex utraque parte semipedis spatio quam parietis corpus increscet
Si solida et constricta inuenietur argilla quinta uel sexta pars altitudinis eius quae supra terram futura est fundamentis deputetur	Sed totus fabricae tractus unius lateris longitudine in quo frons erit meridianam partem respiciat in primo angulo excipiens ortum solis hiberni et paululum ab occidente auertatur hiemali
saxa contusa duabus partibus et una calcis temperante consitues	Sed si aestiuae mansiones sunt orientem solstitialem et partem septemtrionis aspiciant et uel testaceum sicut supra diximus accipiant pauimentum uel marmora uel tesseras aut scutulas quibus aequale reddatur angulis lateribus que coniunctis
In duabus harenae partibus calcis una miscenda est	In fluuiali uero harena si tertiam partem testae cretae addideris operum soliditas mira praestabitur
Quod ubi deducto umore siccatum est ne rimis in aliqua parte findatur etiam parietes simili corio uelentur obducti et ita post duiturnam et solidam siccitatem aquae praebeatur hospitium	Situs horreorum quamuis ipsam septemtrionis desideret partem et superior et longe ab omni umore et laetamine et stabulis ponendus est frigidus uentosus et siccus cui prouidendum structurae diligentia ne rimis possit abrumpi
Olearis cella meridianis sit obiecta partibus et contra frigus munita ut illi per specularia debeat lumen admitti	Stabula equorum uel boum meridianas quidem respiciant partes
Columbarium uero potest accipere sublimis una turricula in praetorio constituta leuigatis ac dealbatis parietibus in quibus a quattuor partibus fenestellae sicut mos est breuissimae fiant ut columbas solas ad introitum exitum que permittant	Vnam partem oui notabis ut te subinde conuertisse cognoscas
Obseruandum sane est ut offulae ipsae oleo leuigentur asperso et ita inserantur faucibus ne sub infima linguae parte mergantur	Graeci saginandis anseribus polentae duas partes et furfuris quattuor aqua calida temperant et ingerunt pro adpetentis uoluntate sumenda
Feni palearum ligni cannarum repositiones nil refert in qua parte dummodo siccae sint atque perflabiles et longe remoueantur a uilla propter casum subripientis incendii	Illud quoque custodies in hortis quos umoris natura non adiuuat ut diuidas partes et hieme ad meridiem aestate ad septemtrionem spatia colenda conuertas
Alii luto inter formas clauso parietes figuratos ex partibus imitantur	Partes sane horti sic diuidendae sunt ut hae in quibus autumno seminabitur uerno tempore pastinentur
Inter areas si umor consueuit effluere spatia altiora ipis areis esse debebunt ut facilius ingrediatur aream de superiori parte umor admissus et ubi sitientem saturauerit in alias possit exclusus auerti	in cuius aditu nucem intus incensam sic poni ut ab una parte flatus possit accipere quos ab alia parte diffundat
in cuius aditu nucem intus incensam sic poni ut ab una parte flatus possit accipere quos ab alia parte diffundat	Apibus stationem non longe a domnicalibus uel in horti parte secreta et aprica et a uentis remota et calidiore locare debemus quae in quadratam constituta mensuram fures et accessus hominum pecudum que submoueat
Sint autem arbores a septemtrionali parte dispositae	Itaque balneum constituemus in ea parte qua calor futurus est loco ab umore suspenso ne uligo eum fornacibus uicina refrigeret
Lumina ei dabimus a parte meridiana et occidentis hiberni ut tota die solis iuuentur et inlustretur aspectu	Picem duram ceram albam ponderibus aequis stupam picis liquidae totius ponderis dimidiam partem testam minutam florem calcis omnia simul mixta confundes et iuncturis curabis inserere
Instrumenta uero haec quae ruri necessaria sunt paremus aratra simplicia uel si plana regio permittit aurita quibus possit contra stationes umoris hiberni sata celsior sulcus adtollere bidentes dolabras falces putatorias quibus in arbore utamur et uite item messorias uel fenarias ligones lupos id est serrulas manubriatas minores maiores que ad mensuram cubiti quibus facile est quod per serram fieri non potest resecando trunco arboris aut uitis interseri acus per quas in pastinis sarmenta merguntur falces a tergo acutas atque lunatas cultellos item curuos minores per quos nouellis arboribus surculi aridi aut extantes facilius amputentur item falciculas breuissimas tubulatas quibus silicem solemus abscidere serrulas minores uangas runcones quibus uepreta persequimur secures simplices uel dolabratas sarculos uel simplices uel bicornes uel ascias in auersa parte referentes rastros item cauteres castratoria ferramenta atque tonsoria uel quae ad animalia solent pertinere medicinam Tunicas uero pellicias cum cucullis et ocreas manicas que de pellibus quae uel in siluis uel in uepribus rustico operi et uenatorio possint esse communes	Tabulas autem pro domini uoluptate uel loci ratione faciemus siue integrum iugerum continentes seu medium seu quartanariam tabulam quae quartam iugeri partem quadrata conficiet
Si minus ferre coeperit tedae cuneus eius radicibus inseratur uel circa ultimam partem fossa facta cumulo ingesti cineris adaequetur	Item secta per partes siccantur in sole et seruantur in uasculis in hibernum
Cacumen ipsum cum ponimus nucem in aquilonis partem dirigemus	Quanto recentius fuerit tanto plus nutriendis herbis ualebit quod a superiori parte fundatur ut sucus eius per totum possit elabi
Et circa martias calendas subacto sicut in hortis solo formandae sunt areae latae pedibus decem longae pedibus quinquaginta ita ut eis aqua ministretur et facile possint ex utraque parte runcari	Erit et hoc signum fertilitatis si de duro aliquo loco fructum citabit si fetu inpleuerit ramulos ex ima parte surgentes
Caput sarmenti cum deponitur torquendum non est ne c aliquo more uexandum ne demersa penitus fecundiore parte quod sterili proximum est supra terram relinquatur	deinde quod ipsa tortura uexatio est et pars ea de qua radix praesumitur iniuriae nulli subicienda est cum qua contendere cogatur antequam teneat
Haec ad arborem cui uitis adhaeret fertur et in fundi media parte pertunditur quod sarmenti uirgam possit admittere	Inducto itaque sarmento uitis eius de qua transferre disponis corbicula ipsa ex aliqua arboris parte suspenditur et uiua terra repletur ut sarmentum terra possit includi quod sarmentum prius intorquetur
Sed ubi multae sunt uineae diuidantur et pars earum quae septemtrionem respiciet uerno putetur	alia pars aduersa clementioribus plagis recidatur autumno
Nam quae altius colitur et fecunda est plus quam octo palmites habere non debet ita ut consideremus semper in inferiori parte custodem	Sed prouidendum ne in una parte sint sarmenta quae seruas
Nulla enim vitae pars ne que publicis ne que privatis ne que forensibus ne que domesticis in rebus ne que si te cum agas quid ne que si cum altero contrahas vacare officio potest in eo que et colendo sita vitae est honestas omnis et neglegendo turpitudo	Ita quam ille triplicem putavit esse rationem in quinque partes distribui debere reperitur
Itaque eorum ipsorum quae aspectu sentiuntur nullum aliud animal pulchritudinem venustatem convenientiam partium sentit	Sed omne quod est honestum id quattuor partium oritur ex aliqua
Quae quattuor quamquam inter se colligata atque implicata sunt tamen ex singulis certa officiorum genera nascuntur velut ex ea parte quae prima discripta est in qua sapientiam et prudentiam ponimus inest indagatio atque inventio veri eius que virtutis hoc munus est proprium	cuius partes duae iustitia in qua virtutis est splendor maximus ex qua viri boni nominantur et huic coniuncta beneficentia quam eandem vel benignitatem vel liberalitatem appellari licet
Sed quoniam ut praeclare scriptum est a Platone non nobis solum nati sumus ortus que nostri partem patria vindicat partem amici atque ut placet Stoicis quae in terris gignantur ad usum hominum omnia creari homines autem hominum causa esse generatos ut ipsi inter se aliis alii prodesse possent in hoc naturam debemus ducem sequi communes utilitates in medium afferre mutatione officiorum dando accipiendo tum artibus tum opera tum facultatibus devincire hominum inter homines societatem	Sed quoniam ut praeclare scriptum est a Platone non nobis solum nati sumus ortus que nostri partem patria vindicat partem amici atque ut placet Stoicis quae in terris gignantur ad usum hominum omnia creari homines autem hominum causa esse generatos ut ipsi inter se aliis alii prodesse possent in hoc naturam debemus ducem sequi communes utilitates in medium afferre mutatione officiorum dando accipiendo tum artibus tum opera tum facultatibus devincire hominum inter homines societatem
Maximam autem partem ad iniuriam faciendam aggrediuntur ut adipiscantur ea quae concupiverunt	Licet eadem de Pausania Lysandro que dicere quorum rebus gestis quamquam imperium Lacedaemoniis partum putatur tamen ne minima quidem ex parte Lycurgi legibus et disciplinae conferendi sunt
Quamquam hoc animi illud etiam ingenii magni est praecipere cogitatione futura et aliquanto ante constituere quid accidere possit in utramque partem et quid agendum sit cum quid evenerit ne c committere ut aliquando dicendum sit	Omnino qui rei publicae praefuturi sunt duo Platonis praecepta teneant unum ut utilitatem civium sic tueantur ut quaecumque agunt ad eam referant obliti commodorum suorum alterum ut totum corpus rei publicae curent ne dum partem aliquam tuentur reliquas deserant
Sequitur ut de una reliqua parte honestatis dicendum sit in qua verecundia et quasi quidam ornatus vitae temperantia et modestia omnis que sedatio perturbationum animi et rerum modus cernitur	Itaque non solum in hac parte honestatis de qua hoc loco disserendum est sed etiam in tribus superioribus quid deceat apparet
nam et generale quoddam decorum intellegimus quod in omni honestate versatur et aliud huic subiectum quod pertinet ad singulas partes honestatis	Quae autem pars subiecta generi est eam sic definiunt ut id decorum velint esse quod ita naturae consentaneum sit ut in eo moderatio et temperantia appareat cum specie quadam liberali
nobis autem cum a natura constantiae moderationis temperantiae verecundiae partes datae sint cum que eadem natura doceat non neglegere quem ad modum nos adversus homines geramus efficitur ut et illud quod ad omnem honestatem pertinet decorum quam late fusum sit appareat et hoc quod spectatur in uno quoque genere virtutis	Ut enim pulchritudo corporis apta compositione membrorum movet oculos et delectat hoc ipso quod inter se omnes partes cum quodam lepore consentiunt sic hoc decorum quod elucet in vita movet approbationem eorum quibus cum vivitur ordine et constantia et moderatione dictorum omnium atque factorum
Iustitiae partes sunt non violare homines verecundiae non offendere	Sed maxima vis decori in hac inest parte de qua disputamus
una pars in appetitu posita est quae est ὁρμή Graece quae hominem huc et illuc rapit altera in ratione quae docet et explanat quid faciendum fugiendum que sit	de eo mihi Valerius interpres nuntiat Thyillus que se audisse scribit haec esse hominem cum Antonio Antonium porro in cogendis pecuniis dictitare partem mihi quaeri et a me custodem communis quaestus libertum esse missum
eius autem conlega et in me perhonorificus et partium studiosus ac defensor bonarum	ex altera parte facile quadringenti fuerunt
ne que id magis amicitia Clodi adductus fecit quam studio perditarum rerum atque partium	illa pars epistulae tuae minime fuit necessaria in qua exponis quas facultates aut provincialium aut urbanorum commodorum et aliis temporibus et me ipso consule praetermiseris
nunc autem ea fuit necessaria propter eam partem epistulae tuae per quam te ac mores tuos mihi purgatos ac probatos esse voluisti	quin etiam si mihi nemo invideret si omnes ut erat aequum faverent tamen non minus esset probanda medicina quae sanaret vitiosas partis rei publicae quam quae exsecaret
interea cursus quos prima a parte iuventae quos que adeo consul virtute animo que petisti hos retine atque auge famam laudes que bonorum	fecisti mihi pergratum quod Serapionis librum ad me misisti ex quo quidem ego quod inter nos liceat dicere millesimam partem vix intellego
ecce ex altera parte Sebosus ille Catuli familiaris	quod si in eam me partem incitarem profecto iam aliquam reperirem resistendi viam
sentiunt se nullam ullius partis voluntatem tenere	rem publicam nulla ex parte attingimus
et simul intellegebam ex eo loco si te haberem posse me Brundisium referre sine te autem non esse nobis illas partis tenendas propter Autronium	ego et saepius ad te et plura scriberem nisi mihi dolor meus cum omnis partis mentis tum maxime huius generis facultatem ademisset
ea si qui casus aliqua ex parte correxerit minus moleste feremus nos vixisse et adhuc vivere	quod facultates tuas ad meam salutem polliceris ut omnibus rebus a te praeter ceteros iuver id quantum sit praesidium video intellego que te multas partis meae salutis et suscipere et posse sustinere ne que ut ita facias rogandum esse
te oro ut si quid erit quod perspicias quamcumque in partem quam planissime ad me scribas et meo nomine ut scribis litteras quibus putabis opus esse ut des	ne que enim sed bonam in partem accipies si ulla spes salutis nostrae subesset tu pro tuo amore in me hoc tempore discessisses
cum pontifices decressent ita si ne que populi iussu ne que plebis scitu is qui se dedicasse diceret nominatim ei rei praefectus esset ne que populi iussu aut plebis scitu id facere iussus esset videri posse sine religione eam partem areae mihi restitui mihi facta statim est gratulatio	cuius plurimae me hercule partes sunt in tuo reditu
haec ad te scripsi fortasse pluribus quam necesse fuit ut videres tuas quoque esse partis instituendi et monendi	Cassius in oppido Antiochia est cum omni exercitu nos in Cappadocia ad Taurum cum exercitu ad Cybistra hostis in Cyrrhestica quae Syriae pars proxima est provinciae meae
ex his castris cum graves de Parthis nuntii venirent perrexi in Ciliciam per Cappadociae partem eam quae Ciliciam attingit eo consilio ut Armenius Artavasdes et ipsi Parthi Cappadocia se excludi putarent	illud me mi Attice in extrema fere parte epistulae commovit
et admonitus in somnis secessit in partes Galilaeae	et egressus inde Iesus secessit in partes Tyri et Sidonis
venit autem Iesus in partes Caesareae Philippi	si autem dixerit malus servus ille in corde suo moram facit dominus meus venire et coeperit percutere conservos suos manducet autem et bibat cum ebriis veniet dominus servi illius in die qua non sperat et hora qua ignorat et dividet eum partem que eius ponet cum hypocritis
et ecce velum templi scissum est in duas partes a summo usque deorsum	et discubuerunt in partes per centenos et per quinquagenos
et statim ascendens navem cum discipulis suis venit in partes Dalmanutha	et non invenientes qua parte illum inferrent prae turba ascenderunt supra tectum
Maria optimam partem elegit quae non auferetur ab ea	si ergo corpus tuum totum lucidum fuerit non habens aliquam partem tenebrarum erit lucidum totum et sicut lucerna fulgoris inluminabit te
quod si dixerit servus ille in corde suo moram facit dominus meus venire et coeperit percutere pueros et ancillas et edere et bibere et inebriari veniet dominus servi illius in die qua non sperat et hora qua nescit et dividet eum partem que eius cum infidelibus ponet	at illi obtulerunt ei partem piscis assi et favum mellis
si non lavero te non habes partem me cum	milites ergo cum crucifixissent eum acceperunt vestimenta eius et fecerunt quattuor partes unicuique militi partem et tunicam
milites ergo cum crucifixissent eum acceperunt vestimenta eius et fecerunt quattuor partes unicuique militi partem et tunicam	Parthi et Medi et Elamitae et qui habitant Mesopotamiam et Iudaeam et Cappadociam Pontum et Asiam Frygiam et Pamphiliam Aegyptum et partes Lybiae quae est circa Cyrenen et advenae romani Iudaei quoque et proselyti Cretes et Arabes audivimus loquentes eos nostris linguis magnalia Dei
et adferens partem quandam ad pedes apostolorum posuit	non est tibi pars ne que sors in sermone isto
et inde Philippis quae est prima partis Macedoniae civitas colonia	factum est autem cum Apollo esset Corinthi ut Paulus peragratis superioribus partibus veniret Ephesum et inveniret quosdam discipulos
non solum autem haec periclitabitur nobis pars in redargutionem venire sed et magnae deae Dianae templum in nihilum reputabitur sed et destrui incipiet maiestas eius quam tota Asia et orbis colit	cum autem perambulasset partes illas et exhortatus eos fuisset multo sermone venit ad Graeciam
sciens autem Paulus quia una pars esset Sadducaeorum et altera Pharisaeorum exclamavit in concilio	nolo enim vos ignorare fratres mysterium hoc ut non sitis vobis ipsis sapientes quia caecitas ex parte contigit in Israhel donec plenitudo gentium intraret et sic omnis Israhel salvus fieret
audacius autem scripsi vobis fratres ex parte tamquam in memoriam vos reducens	cum in Hispaniam proficisci coepero spero quod praeteriens videam vos et a vobis deducar illuc si vobis primum ex parte fruitus fuero
primum quidem convenientibus vobis in ecclesia audio scissuras esse et ex parte credo	ex parte enim cognoscimus et ex parte prophetamus
ex parte enim cognoscimus et ex parte prophetamus	cum autem venerit quod perfectum est evacuabitur quod ex parte est
nunc cognosco ex parte	si ve lingua quis loquitur secundum duos aut ut multum tres et per partes et unus interpretetur
spero autem quod usque in finem cognoscetis sicut et cognovistis nos ex parte quia gloria vestra sumus sicut et vos nostra in die Domini nostri Iesu Christi	si quis autem contristavit non me contristavit sed ex parte ut non onerem omnes vos
nam nec glorificatum est quod claruit in hac parte propter excellentem gloriam	aut quae pars fideli cum infidele
misi autem fratres ut ne quod gloriamur de vobis evacuetur in hac parte ut quemadmodum dixi parati sitis ne cum venerint me cum Macedones et invenerint vos inparatos erubescamus nos ut non dicamus vos in hac substantia	deinde veni in partes Syriae et Ciliciae
quod autem ascendit quid est nisi quia et descendit primum in inferiores partes terrae	nemo ergo vos iudicet in cibo aut in potu aut in parte diei festi aut neomeniae aut sabbatorum
et de ore eius gladius utraque parte acutus exiebat	haec dicit qui habet rompheam utraque parte acutam
et qui sedebat desuper nomen illi Mors et inferus sequebatur eum et data est illi potestas super quattuor partes terrae interficere gladio fame et morte et bestiis terrae	et primus tuba cecinit et facta est grando et ignis mixta in sanguine et missum est in terram et tertia pars terrae conbusta est et tertia pars arborum conbusta est et omne faenum viride conbustum est
et primus tuba cecinit et facta est grando et ignis mixta in sanguine et missum est in terram et tertia pars terrae conbusta est et tertia pars arborum conbusta est et omne faenum viride conbustum est	et tamquam mons magnus igne ardens missus est in mare et facta est tertia pars maris sanguis et mortua est tertia pars creaturae quae habent animas et tertia pars navium interiit
et tamquam mons magnus igne ardens missus est in mare et facta est tertia pars maris sanguis et mortua est tertia pars creaturae quae habent animas et tertia pars navium interiit	et tamquam mons magnus igne ardens missus est in mare et facta est tertia pars maris sanguis et mortua est tertia pars creaturae quae habent animas et tertia pars navium interiit
et cecidit de caelo stella magna ardens tamquam facula et cecidit in tertiam partem fluminum et in fontes aquarum	et nomen stellae dicitur Absinthius et facta est tertia pars aquarum in absinthium et multi hominum mortui sunt de aquis quia amarae factae sunt
et percussa est tertia pars solis et tertia pars lunae et tertia pars stellarum ut obscuraretur tertia pars eorum et diei non luceret pars tertia et nox similiter	et percussa est tertia pars solis et tertia pars lunae et tertia pars stellarum ut obscuraretur tertia pars eorum et diei non luceret pars tertia et nox similiter
et percussa est tertia pars solis et tertia pars lunae et tertia pars stellarum ut obscuraretur tertia pars eorum et diei non luceret pars tertia et nox similiter	et percussa est tertia pars solis et tertia pars lunae et tertia pars stellarum ut obscuraretur tertia pars eorum et diei non luceret pars tertia et nox similiter
et percussa est tertia pars solis et tertia pars lunae et tertia pars stellarum ut obscuraretur tertia pars eorum et diei non luceret pars tertia et nox similiter	et soluti sunt quattuor angeli qui parati erant in horam et diem et mensem et annum ut occiderent tertiam partem hominum
ab his tribus plagis occisa est tertia pars hominum de igne et fumo et sulphure qui procedebat ex ore ipsorum	et in illa hora factus est terraemotus magnus et decima pars civitatis cecidit
et in capitibus suis septem diademata et cauda eius trahebat tertiam partem stellarum caeli et misit eas in terram	et facta est civitas magna in tres partes
beatus et sanctus qui habet partem in resurrectione prima	timidis autem et incredulis et execratis et homicidis et fornicatoribus et veneficis et idolatris et omnibus mendacibus pars illorum erit in stagno ardenti igne et sulphure
et si quis deminuerit de verbis libri prophetiae huius auferet Deus partem eius de ligno vitae et de civitate sancta et de his quae scripta sunt in libro isto	Gallia est omnis divisa in partes tres quarum unam incolunt Belgae aliam Aquitani tertiam qui ipsorum lingua Celtae nostra Galli appellantur
Id hoc facilius iis persuasit quod undique loci natura Helvetii continentur una ex parte flumine Rheno latissimo atque altissimo qui agrum Helvetium a Germanis dividit altera ex parte monte Iura altissimo qui est inter Sequanos et Helvetios tertia lacu Lemanno et flumine Rhodano qui provinciam nostram ab Helvetiis dividit	Id hoc facilius iis persuasit quod undique loci natura Helvetii continentur una ex parte flumine Rheno latissimo atque altissimo qui agrum Helvetium a Germanis dividit altera ex parte monte Iura altissimo qui est inter Sequanos et Helvetios tertia lacu Lemanno et flumine Rhodano qui provinciam nostram ab Helvetiis dividit
qua ex parte homines bellandi cupidi magno dolore adficiebantur	Flumen est Arar quod per fines Haeduorum et Sequanorum in Rhodanum influit incredibili lenitate ita ut oculis in utram partem fluat iudicari non possit
Ubi per exploratores Caesar certior factus est tres iam partes copiarum Helvetios id flumen traduxisse quartam vero partem citra flumen Ararim reliquam esse de tertia vigilia cum legionibus tribus e castris profectus ad eam partem pervenit quae nondum flumen transierat	Eos impeditos et inopinantes adgressus magnam partem eorum concidit
Ita sive casu sive consilio deorum immortalium quae pars civitatis Helvetiae insignem calamitatem populo Romano intulerat ea princeps poenam persolvit	si pacem populus Romanus cum Helvetiis faceret in eam partem ituros atque ibi futuros Helvetios ubi eos Caesar constituisset atque esse voluisset
Idem facit Caesar equitatum que omnem ad numerum quattuor milium quem ex omni provincia et Haeduis atque eorum sociis coactum habebat praemittit qui videant quas in partes hostes iter faciant	Ubi se diutius duci intellexit et diem instare quo die frumentum militibus metiri oporteret convocatis eorum principibus quorum magnam copiam in castris habebat in his Diviciaco et Lisco qui summo magistratui praeerat quem vergobretum appellant Haedui qui creatur annuus et vitae necis que in suos habet potestatem graviter eos accusat quod cum ne que emi ne que ex agris sumi possit tam necessario tempore tam propinquis hostibus ab iis non sublevetur praesertim cum magna ex parte eorum precibus adductus bellum susceperit
Sed peius victoribus Sequanis quam Haeduis victis accidisse propterea quod Ariovistus rex Germanorum in eorum finibus consedisset tertiam que partem agri Sequani qui esset optimus totius Galliae occupavisset et nunc de altera parte tertia Sequanos decedere iuberet propterea quod paucis mensibus ante Harudum milia hominum viginti quattuor ad eum venissent quibus locus ac sedes pararentur	Sed peius victoribus Sequanis quam Haeduis victis accidisse propterea quod Ariovistus rex Germanorum in eorum finibus consedisset tertiam que partem agri Sequani qui esset optimus totius Galliae occupavisset et nunc de altera parte tertia Sequanos decedere iuberet propterea quod paucis mensibus ante Harudum milia hominum viginti quattuor ad eum venissent quibus locus ac sedes pararentur
Praeterea se ne que sine exercitu in eas partes Galliae venire audere quas Caesar possideret ne que exercitum sine magno commeatu atque molimento in unum locum contrahere posse	reliquum spatium quod est non amplius pedum milium sescentorum qua flumen intermittit mons continet magna altitudine ita ut radices eius montis ex utraque parte ripae fluminis contingant
Haec cum animadvertisset convocato consilio omnium que ordinum ad id consilium adhibitis centurionibus vehementer eos incusavit primum quod aut quam in partem aut quo consilio ducerentur sibi quaerendum aut cogitandum putarent	Postulavit deinde eadem quae legatis in mandatis dederat ne aut Haeduis aut eorum sociis bellum inferret obsides redderet si nullam partem Germanorum domum remittere posset at ne quos amplius Rhenum transire pateretur
Munitis castris duas ibi legiones reliquit et partem auxiliorum	Tum demum Ariovistus partem suarum copiarum quae castra minora oppugnaret misit
ipse a dextro cornu quod eam partem minime firmam hostium esse animadverterat proelium commisit	Cum esset Caesar in citeriore Gallia ita uti supra demonstravimus crebri ad eum rumores adferebantur litteris que item Labieni certior fiebat omnes Belgas quam tertiam esse Galliae partem dixeramus contra populum Romanum coniurare obsides que inter se dare
Apud eos fuisse regem nostra etiam memoria Diviciacum totius Galliae potentissimum qui cum magnae partis harum regionum tum etiam Britanniae imperium obtinuerit	Ibi praesidium ponit et in altera parte fluminis Quintum Titurium Sabinum legatum cum sex cohortibus relinquit
Ubi nostros non esse inferiores intellexit loco pro castris ad aciem instruendam natura oportuno atque idoneo quod is collis ubi castra posita erant paululum ex planitie editus tantum adversus in latitudinem patebat quantum loci acies instructa occupare poterat atque ex utraque parte lateris deiectus habebat et in fronte leniter fastigatus paulatim ad planitiem redibat ab utroque latere eius collis transversam fossam obduxit circiter passuum quadringentorum et ad extremas fossas castella constituit ibi que tormenta conlocavit ne cum aciem instruxisset hostes quod tantum multitudine poterant ab lateribus pugnantes suos circumvenire possent	Ibi vadis repertis partem suarum copiarum traducere conati sunt eo consilio ut si possent castellum cui praeerat Quintus Titurius legatus expugnarent pontem que interscinderent si minus potuissent agros Remorum popularentur qui magno nobis usui ad bellum gerendum erant commeatu que nostros prohiberent
Ab eo flumine pari acclivitate collis nascebatur adversus huic et contrarius passus circiter ducentos infimus apertus ab superiore parte silvestris ut non facile introrsus perspici posset	Quarum rerum magnam partem temporis brevitas et incursus hostium impediebat
Caesar necessariis rebus imperatis ad cohortandos milites quam partem fors obtulit decucurrit et ad legionem decimam devenit	Quam quisque ab opere in partem casu devenit quae que prima signa conspexit ad haec constitit ne in quaerendis suis pugnandi tempus dimitteret
Instructo exercitu magis ut loci natura et necessitas temporis quam ut rei militaris ratio atque ordo postulabat cum diversae legiones aliae alia in parte hostibus resisterent saepibus que densissimis ut ante demonstravimus interiectis prospectus impediretur ne que certa subsidia conlocari ne que quid in quaque parte opus esset provideri ne que ab uno omnia imperia administrari poterant	Instructo exercitu magis ut loci natura et necessitas temporis quam ut rei militaris ratio atque ordo postulabat cum diversae legiones aliae alia in parte hostibus resisterent saepibus que densissimis ut ante demonstravimus interiectis prospectus impediretur ne que certa subsidia conlocari ne que quid in quaque parte opus esset provideri ne que ab uno omnia imperia administrari poterant
Legionis nonae et decimae milites ut in sinistra parte aciei constiterant pilis emissis cursu ac lassitudine exanimatos vulneribus que confectos Atrebates nam his ea pars obvenerat celeriter ex loco superiore in flumen compulerunt et transire conantes insecuti gladiis magnam partem eorum impeditam interfecerunt	Legionis nonae et decimae milites ut in sinistra parte aciei constiterant pilis emissis cursu ac lassitudine exanimatos vulneribus que confectos Atrebates nam his ea pars obvenerat celeriter ex loco superiore in flumen compulerunt et transire conantes insecuti gladiis magnam partem eorum impeditam interfecerunt
Legionis nonae et decimae milites ut in sinistra parte aciei constiterant pilis emissis cursu ac lassitudine exanimatos vulneribus que confectos Atrebates nam his ea pars obvenerat celeriter ex loco superiore in flumen compulerunt et transire conantes insecuti gladiis magnam partem eorum impeditam interfecerunt	Item alia in parte diversae duae legiones undecima et octava profligatis Viromanduis quibus cum erant congressae ex loco superiore in ipsis fluminis ripis proeliabantur
At totis fere castris a fronte et a sinistra parte nudatis cum in dextro cornu legio duodecima et non magno ab ea intervallo septima constitisset omnes Nervii confertissimo agmine duce Boduognato qui summam imperii tenebat ad eum locum contenderunt	quorum pars ab aperto latere legiones circumvenire pars summum castrorum locum petere coepit
quorum pars ab aperto latere legiones circumvenire pars summum castrorum locum petere coepit	Eodem tempore equites nostri levis que armaturae pedites qui cum iis una fuerant quos primo hostium impetu pulsos dixeram cum se in castra reciperent adversis hostibus occurrebant ac rursus aliam in partem fugam petebant
Simul eorum qui cum impedimentis veniebant clamor fremitus que oriebatur alii que aliam in partem perterriti ferebantur	Quibus omnibus rebus permoti equites Treveri quorum inter Gallos virtutis opinio est singularis qui auxilii causa a civitate missi ad Caesarem venerant cum multitudine hostium castra compleri legiones premi et paene circumventas teneri calones equites tunditores Numidas diversos dissipatos que in omnes partes fugere vidissent desperatis nostris rebus domum contenderunt
Quod cum ex omnibus in circuitu partibus altissimas rupes deiectus que haberet una ex parte leniter acclivis aditus in latitudinem non amplius pedum ducentorum relinquebatur	Quod cum ex omnibus in circuitu partibus altissimas rupes deiectus que haberet una ex parte leniter acclivis aditus in latitudinem non amplius pedum ducentorum relinquebatur
Armorum magna multitudine de muro in fossam quae erat ante oppidum iacta sic ut prope summam muri aggeris que altitudinem acervi armorum adaequarent et tamen circiter parte tertia ut postea perspectum est celata atque in oppido retenta portis patefactis eo die pace sunt usi	Cum in Italiam proficisceretur Caesar Servium Galbam cum legione duodecima et parte equitatus in Nantuates Veragros Sedunos que misit qui a finibus Allobrogum et lacu Lemanno et flumine Rhodano ad summas Alpes pertinent
Cum hic in duas partes flumine divideretur alteram partem eius vici Gallis concessit alteram vacuam ab his relictam cohortibus attribuit	Cum hic in duas partes flumine divideretur alteram partem eius vici Gallis concessit alteram vacuam ab his relictam cohortibus attribuit
Cum dies hibernorum complures transissent frumentum que eo comportari iussisset subito per exploratores certior factus est ex ea parte vici quam Gallis concesserat omnes noctu discessisse montes que qui impenderent a maxima multitudine Sedunorum et Veragrorum teneri	Maiori tamen parti placuit hoc reservato ad extremum casum consilio interim rei eventum experiri et castra defendere
Brevi spatio interiecto vix ut iis rebus quas constituissent conlocandis atque administrandis tempus daretur hostes ex omnibus partibus signo dato decurrere	Nostri primo integris viribus fortiter propugnare ne que ullum flustra telum ex loco superiore mittere et quaecumque pars castrorum nudata defensoribus premi videbatur eo occurrere et auxilium ferre sed hoc superari quod diuturnitate pugnae hostes defessi proelio excedebant alii integris viribus succedebant
Ita commutata fortuna eos qui in spem potiundorum castrorum venerant undique circumventos intercipiunt et ex hominum milibus amplius triginta quem numerum barbarorum ad castra venisse constabat plus tertia parte interfecta reliquos perterritos in fugam coiciunt ac ne in locis quidem superioribus consistere patiuntur	Erant hae difficultates belli gerendi quas supra ostendimus sed tamen multa Caesarem ad id bellum incitabant iniuria retentorum equitum Romanorum rebellio facta post deditionem defectio datis obsidibus tot civitatum coniuratio in primis ne hac parte neglecta reliquae nationes sibi idem licere arbitrarentur
Haec eo facilius magnam partem aestatis faciebant quod nostrae naves tempestatibus detinebantur summa que erat vasto atque aperto mari magnis aestibus raris ac prope nullis portibus difficultas navigandi	Ac iam conversis in eam partem navibus quo ventus ferebat tanta subito malacia ac tranquillitas extitit ut se ex loco movere non possent
Eodem fere tempore Publius Crassus cum in Aquitaniam pervenisset quae ut ante dictum est tertia pars Galliae est cum intellegeret in iis locis sibi bellum gerendum ubi paucis ante annis Lucius Valerius Praeconinus legatus exercitu pulso interfectus esset atque unde Lucius Manlius proconsul impedimentis amissis profugisset non mediocrem sibi diligentiam adhibendam intellegebat	Atque in eam rem omnium nostrorum intentis animis alia ex parte oppidi Adiatunnus qui summam imperii tenebat cum sescentis devotis quos illi soldurios appellant
Cum his Adiatunnus eruptionem facere conatus clamore ab ea parte munitionis sublato cum ad arma milites concurrissent vehementer que ibi pugnatum esset repulsus in oppidum tamen uti eadem deditionis condicione uteretur a Crasso impetravit	Tum vero clamore ab ea parte audito nostri redintegratis viribus quod plerumque in spe victoriae accidere consuevit acrius impugnare coeperunt
Quos equitatus apertissimis campis consectatus ex milium quinquaginta numero quae ex Aquitania Cantabris que convenisse constabat vix quarta parte relicta multa nocte se in castra recepit	Hac audita pugna maxima pars Aquitaniae sese Crasso dedidit obsides que ultro misit
Ad quarum initium silvarum cum Caesar pervenisset castra que munire instituisset ne que hostis interim visus esset dispersis in opere nostris subito ex omnibus partibus silvae evolaverunt et in nostros impetum fecerunt	Ne que multum frumento sed maximam partem lacte atque pecore vivunt multum que sunt in venationibus
Atque in eam se consuetudinem adduxerunt ut locis frigidissimis neque vestitus praeter pelles habeant quicquam quarum propter exiguitatem magna est corporis pars aperta et laventur in fluminibus	Itaque una ex parte a Suebis circiter milia passuum centum agri vacare dicuntur
Ad alteram partem succedunt Ubii quorum fuit civitas ampla atque florens ut est captus Germanorum	His interfectis navibus que eorum occupatis prius quam ea pars Menapiorum quae citra Rhenum erat certior fieret flumen transierunt atque omnibus eorum aedificiis occupatis reliquam partem hiemis se eorum copiis aluerunt
His interfectis navibus que eorum occupatis prius quam ea pars Menapiorum quae citra Rhenum erat certior fieret flumen transierunt atque omnibus eorum aedificiis occupatis reliquam partem hiemis se eorum copiis aluerunt	Cognoverat enim magnam partem equitatus ab iis aliquot diebus ante praedandi frumentandi que causa ad Ambivaritos trans Mosam missam
Accessit etiam quod illa pars equitatus Usipetum et Tencterorum quam supra commemoravi praedandi frumentandi que causa Mosam transisse ne que proelio interfuisse post fugam suorum se trans Rhenum in fines Sugambrorum receperat se que cum his coniunxerat	Haec cum machinationibus immissa in flumen defixerat fistucis que adegerat non sublicae modo derecte ad perpendiculum sed prone ac fastigate ut secundum naturam fluminis procumberent iis item contraria duo ad eundem modum iuncta intervallo pedum quadragenum ab inferiore parte contra vim atque impetum fluminis conversa statuebat
Haec utraque insuper bipedalibus trabibus immissis quantum eorum tignorum iunctura distabat binis utrimque fibulis ab extrema parte distinebantur	quibus disclusis atque in contrariam partem revinctis tanta erat operis firmitudo atque ea rerum natura ut quo maior vis aquae se incitavisset hoc artius inligata tenerentur
ac nihilo setius sublicae et ad inferiorem partem fluminis oblique agebantur quae pro ariete subiectae et cum omni opere coniunctae vim fluminis exciperent et aliae item supra pontem mediocri spatio ut si arborum trunci si ve naves deiciendi operis causa essent a barbaris missae his defensoribus earum rerum vis minueretur neu ponti nocerent	Caesar ad utramque partem pontis firmo praesidio relicto in fines Sugambrorum contendit
Suebos postea quam per exploratores pontem fieri comperissent more suo concilio habito nuntios in omnes partes dimisisse uti de oppidis demigrarent liberos uxores sua que omnia in silvis deponerent atque omnes qui arma ferre possent unum in locum convenirent	Exigua parte aestatis reliqua Caesar etsi in his locis quod omnis Gallia ad septentriones vergit maturae sunt hiemes tamen in Britanniam proficisci contendit quod omnibus fere Gallicis bellis hostibus nostris inde subministrata auxilia intellegebat et si tempus anni ad bellum gerendum deficeret tamen magno sibi usui fore arbitrabatur si modo insulam adisset genus hominum perspexisset loca portus aditus cognovisset
Dum in his locis Caesar navium parandarum causa moratur ex magna parte Morinorum ad eum legati venerunt qui se de superioris temporis consilio excusarent quod homines barbari et nostrae consuetudinis imperiti bellum populo Romano fecissent se que ea quae imperasset facturos pollicerentur	quorum illi partem statim dederunt
partem ex longinquioribus locis arcessitam paucis diebus sese daturos dixerunt	Quae cum adpropinquarent Britanniae et ex castris viderentur tanta tempestas subito coorta est ut nulla earum cursum tenere posset sed aliae eodem unde erant profectae referrentur aliae ad inferiorem partem insulae quae est propius solis occasum magno suo cum periculo deicerentur
Dum ea geruntur legione ex consuetudine una frumentatum missa quae appellabatur septem ne que ulla ad id tempus belli suspicione interposita cum pars hominum in agris remaneret pars etiam in castra ventitaret ii qui pro portis castrorum in statione erant Caesari nuntiaverunt pulverem maiorem quam consuetudo ferret in ea parte videri quam in partem legio iter fecisset	Dum ea geruntur legione ex consuetudine una frumentatum missa quae appellabatur septem ne que ulla ad id tempus belli suspicione interposita cum pars hominum in agris remaneret pars etiam in castra ventitaret ii qui pro portis castrorum in statione erant Caesari nuntiaverunt pulverem maiorem quam consuetudo ferret in ea parte videri quam in partem legio iter fecisset
Dum ea geruntur legione ex consuetudine una frumentatum missa quae appellabatur septem ne que ulla ad id tempus belli suspicione interposita cum pars hominum in agris remaneret pars etiam in castra ventitaret ii qui pro portis castrorum in statione erant Caesari nuntiaverunt pulverem maiorem quam consuetudo ferret in ea parte videri quam in partem legio iter fecisset	Dum ea geruntur legione ex consuetudine una frumentatum missa quae appellabatur septem ne que ulla ad id tempus belli suspicione interposita cum pars hominum in agris remaneret pars etiam in castra ventitaret ii qui pro portis castrorum in statione erant Caesari nuntiaverunt pulverem maiorem quam consuetudo ferret in ea parte videri quam in partem legio iter fecisset
Caesar id quod erat suspicatus aliquid novi a barbaris initum consilii cohortes quae in statione erant se cum in eam partem proficisci ex reliquis duas in stationem succedere reliquas armari et confestim sese subsequi iussit	Cum paulo longius a castris processisset suos ab hostibus premi atque aegre sustinere et conferta legione ex omnibus partibus tela coici animadvertit
Nam quod omni ex reliquis partibus demesso frumento pars una erat reliqua suspicati hostes huc nostros esse venturos noctu in silvis delituerant	Nam quod omni ex reliquis partibus demesso frumento pars una erat reliqua suspicati hostes huc nostros esse venturos noctu in silvis delituerant
Primo per omnes partes perequitant et tela coiciunt atque ipso terrore equorum et strepitu rotarum ordines plerumque perturbant et cum se inter equitum turmas insinuaverunt ex essedis desiliunt et pedibus proeliantur	Interim barbari nuntios in omnes partes dimiserunt paucitatem que nostrorum militum suis praedicaverunt et quanta praedae faciendae atque in perpetuum sui liberandi facultas daretur si Romanos castris expulissent demonstraverunt
Ipse conventibus Galliae citerioris peractis in Illyricum proficiscitur quod a Pirustis finitimam partem provinciae incursionibus vastari audiebat	Itaque dies circiter viginti quinque in eo loco commoratus quod Corus ventus navigationem impediebat qui magnam partem omnis temporis in his locis flare consuevit dabat operam ut in officio Dumnorigem contineret nihilo tamen setius omnia eius consilia cognosceret
Qua re nuntiata Caesar intermissa profectione atque omnibus rebus postpositis magnam partem equitatus ad eum insequendum mittit retrahi que imperat	Hac parte Galliae pacata totus et mente et animo in bellum Treverorum et Ambiorigis insistit
namque omnes civitates divisae sunt in duas partes	Proeliis vero compluribus factis secundis atque omni nobilitate Haeduorum interfecta tantum potentia antecesserant ut magnam partem clientium ab Haeduis ad se traducerent obsides que ab his principum filios acciperent et publice iurare cogerent nihil se contra Sequanos consilii inituros et partem finitimi agri per vim occupatam possiderent Galliae que totius principatum obtinerent
Proeliis vero compluribus factis secundis atque omni nobilitate Haeduorum interfecta tantum potentia antecesserant ut magnam partem clientium ab Haeduis ad se traducerent obsides que ab his principum filios acciperent et publice iurare cogerent nihil se contra Sequanos consilii inituros et partem finitimi agri per vim occupatam possiderent Galliae que totius principatum obtinerent	uter eorum vita superaverit ad eum pars utriusque cum fructibus superiorum temporum pervenit
cuius rei nulla est occultatio quod et promiscue in fluminibus perluuntur et pellibus aut parvis renonum tegimentis utuntur magna corporis parte nuda	Agriculturae non student maior que pars eorum victus in lacte caseo carne consistit
sed ne omnino metum reditus sui barbaris tolleret atque ut eorum auxilia tardaret reducto exercitu partem ultimam pontis quae ripas Ubiorum contingebat in longitudinem pedum ducentorum rescindit atque in extremo ponte turrim tabulatorum quattuor constituit praesidium que cohortium duodecim pontis tuendi causa ponit magnis que eum locum munitionibus firmat	Quorum pars in Arduennam silvam pars in continentes paludes profugit
Quorum pars in Arduennam silvam pars in continentes paludes profugit	Catuvolcus rex dimidiae partis Eburonum qui una cum Ambiorige consilium inierat aetate iam confectus cum laborem belli aut fugae ferre non posset omnibus precibus detestatus Ambiorigem qui eius consilii auctor fuisset taxo cuius magna in Gallia Germania que copia est se exanimavit
Tum copiis in tres partes distributis impedimenta omnium legionum Aduatucam contulit	Partito exercitu Titum Labienum cum legionibus tribus ad Oceanum versus in eas partes quae Menapios attingunt proficisci iubet
ipse cum reliquis tribus ad flumen Scaldim quod influit in Mosam extremas que Arduennae partes ire constituit quo cum paucis equitibus profectum Ambiorigem audiebat	Erat ut supra demonstravimus manus certa nulla non oppidum non praesidium quod se armis defenderet sed in omnes partes dispersa multitudo
quae tamen ex parte res ad salutem exercitus pertinebat	Haec in omnibus Eburonum partibus gerebantur dies que adpetebat septimus quem ad diem Caesar ad impedimenta legionem que reverti constituerat
Hoc ipso tempore casu Germani equites interveniunt protinus que eodem illo quo venerant cursu ab decumana porta in castra inrumpere conantur nec prius sunt visi obiectis ab ea parte silvis quam castris adpropinquarent usque eo ut qui sub vallo tenderent mercatores recipiendi sui facultatem non haberent	Circumfunduntur hostes ex reliquis partibus si quem aditum reperire possent
ne que quo signa ferantur ne que quam in partem quisque conveniat provident	postea despecta paucitate ex omnibus partibus impetum faciunt
quoniam tam propinqua sint castra etsi pars aliqua circumventa ceciderit at reliquos servari posse	Militum pars horum virtute submotis hostibus praeter spem incolumis in castra pervenit
pars a barbaris circumventa periit	Caesar rursus ad vexandos hostes profectus equites magno coacto numero ex finitimis civitatibus in omnes partes dimittit
Ac saepe in eum locum ventum est tanto in omnes partes diviso equitatu ut modo visum ab se Ambiorigem in fuga circumspicerent captivi nec plane etiam abisse ex conspectu contenderent ut spe consequendi inlata atque infinito labore suscepto qui se summam a Caesare gratiam inituros putarent paene naturam studio vincerent semper que paulum ad summam felicitatem defuisse videretur atque ille latebris aut saltibus se eriperet et noctu occultatus alias regiones partes que peteret non maiore equitum praesidio quam quattuor quibus solis vitam suam committere audebat	Ac saepe in eum locum ventum est tanto in omnes partes diviso equitatu ut modo visum ab se Ambiorigem in fuga circumspicerent captivi nec plane etiam abisse ex conspectu contenderent ut spe consequendi inlata atque infinito labore suscepto qui se summam a Caesare gratiam inituros putarent paene naturam studio vincerent semper que paulum ad summam felicitatem defuisse videretur atque ille latebris aut saltibus se eriperet et noctu occultatus alias regiones partes que peteret non maiore equitum praesidio quam quattuor quibus solis vitam suam committere audebat
